NO ./resource/textures/test.xpm
SO ./resource/textures/test.xpm
WE ./resource/textures/test.xpm
EA ./resource/textures/test.xpm
F 220,100,0
C 225,30,0


1111
1N001
1111
