NO ./resource/textures/test.xpm
SO ./resource/textures/test.xpm
WE ./resource/textures/test.xpm
EA ./resource/textures/test.xpm
F 220,100,0
C 225,30,0


111111111111 111111111111
1000000000001000000000001
1000000000000000000000001
1000000000000000000000001
1110111111111111111111111
